11111111111111111111
1P1E100C000000000001
10010000000000000001
11111111111111111111
