1111111111111111
11110C00P00E0001
1111111111111111