11111111111111111111
1P0CE000000000000001
11111111111111111111
11111111111111111111
