111111111111111111111111111
1000101000000000000000C0111
1000000100000P01E0000000111
1000100C00000000000X0000111
111111111111111111111111111