11111111111111111111
1P0CE000C00000000001
10000000000C00010001
11111111111111111111
